Map1
10-10
XXXXXXXXXX
XH  I X GX
XXX XXX  X
X I I X  X
XXX XXX  X
E        X
E        X
XXX XXXX X
X I I Xl X
XXXXXXXXXX

Map2
9-9
XXXXXXXXX
EA  O  kX
X       X
X       X
X       X
X       X
X       X
X       X
XXXXXXXXX

Map3
5-5
XXXXX
XH GX
I   X
Ik  X
XXXXX

Map4
6-8
XXXXXXXX
XA  O  X
X      X
X      X
I   k  X
XXXXXXXX

Map5
6-5
XXXXX
XkOAX
X   X
X   X
X   X
XXEXX
