Map97
9-9
XXXXXXXXX
EAX O  kX
XXX     X
X       X
X       X
X       X
X       X
X       X
XXXXXXXXX

Map98
5-5
XXXXX
XH GX
E   X
El  X
XXXXX

Map99
6-8
XXXXXXXX
XA  OX X
IkXXXX X
X      X
E      X
XXXXXXXX

Map1
10-10
XXXXXXXXXX
XH  I X GX
XXX XXX  X
X I I X  X
XXX XXX  X
E        X
E        X
XXX XXXX X
X I I Xl X
XXXXXXXXXX

Map2
9-9
XXXXXXXXX
EA  O  kX
X       X
X       X
X       X
X       X
X       X
X       X
XXXXXXXXX
